12,12
0 34 34 34 0 0 34 0 0 0 0 0
0 0 0 0 0 0 34 34 6 0 34 34
41 3 0 0 0 0 0 0 0 0 34 34
34 34 34 34 4 34 34 0 0 0 0 0
0 0 0 0 0 0 0 0 0 0 0 0
34 0 34 0 0 34 34 0 34 34 34 0
34 0 34 0 0 34 0 0 0 0 13 4
34 0 34 0 0 11 11 11 11 11 11 0
0 0 0 0 0 18 50 50 50 50 11 0
34 34 0 0 0 18 50 50 50 50 11 0
0 0 4 0 0 11 11 11 50 50 11 13
73 6 34 0 0 6 4 11 50 50 11 4
