12,12
25 3 0 0 0 0 0 0 0 0 0 0
18 18 18 0 18 4 18 0 18 18 18 0
18 0 0 0 18 0 18 0 18 0 0 0
18 18 18 0 4 6 4 0 18 18 18 0
0 0 18 0 18 0 18 0 0 0 18 0
4 18 18 0 18 4 18 0 18 18 18 0
0 0 0 0 0 0 0 0 0 0 0 0
0 0 0 0 34 0 0 0 0 34 34 34
0 0 13 0 0 34 0 0 0 34 0 0
0 0 34 34 34 34 34 0 0 4 6 57
0 0 0 0 4 34 0 0 0 34 0 0
0 0 0 0 34 0 0 6 0 34 34 34
