12,12
25 3 0 0 0 0 0 0 0 0 0 0
0 0 0 0 0 0 0 34 34 34 0 0
0 0 34 0 0 0 0 34 4 34 0 0
0 0 34 0 34 0 6 34 0 34 6 0
0 0 34 0 34 0 0 34 0 34 0 0
0 0 34 0 0 0 0 0 0 0 0 0
34 0 0 0 34 34 0 0 0 0 0 0
34 0 0 0 0 0 0 34 34 34 34 0
0 0 34 0 0 0 0 0 0 4 34 0
0 6 34 0 34 34 0 0 34 34 34 0
4 4 34 0 0 0 0 0 0 0 0 4
18 8 34 0 0 18 34 34 34 0 6 58

