12,12
0 0 0 34 34 0 0 34 34 34 34 4
34 0 0 0 34 0 0 34 13 4 34 8
25 3 0 0 4 0 0 0 0 34 0 13
34 34 34 34 0 0 0 0 0 34 4 4
0 0 0 0 18 0 0 0 0 0 0 0
0 13 0 0 0 0 0 0 0 0 18 0
0 34 0 0 0 0 34 34 34 0 0 0
0 34 0 6 0 0 0 13 34 0 0 0
0 34 34 34 0 0 34 34 34 0 0 0
0 0 0 34 0 0 34 4 0 0 0 6
34 0 0 34 0 0 34 34 34 0 0 0
58 6 0 0 0 0 6 0 0 0 0 0
