12,12
34 34 34 34 34 9 34 34 4 34 0 4
0 0 0 0 34 3 34 18 0 18 0 6
6 0 34 0 0 0 0 0 0 0 0 0
0 0 0 0 0 0 0 0 0 0 18 34
34 34 34 0 0 34 34 34 0 0 0 4
34 0 0 0 0 34 4 34 0 0 18 34
13 0 0 0 0 34 0 0 0 34 0 0
34 18 0 0 0 0 0 0 0 0 0 6
4 0 0 0 34 0 0 34 0 34 34 0
34 18 0 34 0 0 0 0 0 0 0 0
34 34 0 0 0 34 34 34 4 18 18 18
6 0 0 0 0 34 34 34 0 6 0 41
