12,12
9 3 0 0 0 0 18 18 18 34 34 4
34 34 34 0 34 0 0 0 0 34 34 0
4 13 34 0 34 34 34 34 0 0 0 0
34 0 34 0 0 0 0 34 0 34 34 34
34 0 34 34 34 0 0 34 0 34 0 0
34 0 0 0 0 0 0 34 0 34 0 0
34 34 34 0 34 34 34 34 0 0 0 0
0 0 0 0 0 0 0 0 0 34 34 34
34 34 0 34 34 34 34 34 34 34 0 4
34 34 0 0 0 0 0 0 0 0 0 6
4 6 0 34 0 34 34 4 34 34 34 34
34 34 34 34 0 34 34 13 0 0 6 41
