12,12
3 0 14 0 0 0 0 0 0 0 0 0
0 0 0 0 0 0 0 0 0 0 0 0
14 0 0 0 18 0 0 18 0 0 0 0
0 0 0 0 18 0 0 18 0 0 0 0
0 0 18 18 18 0 0 18 18 18 0 0
0 0 0 0 0 0 15 0 0 0 0 0
0 0 0 0 0 0 0 0 0 0 0 0
0 0 18 18 18 0 0 18 18 18 0 0
0 0 0 0 18 0 0 18 0 0 0 0
0 0 0 0 18 0 0 18 0 0 0 14
0 0 0 0 0 0 0 0 0 0 74 0
0 0 0 0 0 0 0 0 0 14 0 17

