12,12
0 0 0 0 0 0 0 0 0 0 0 0 
6 0 0 0 34 34 0 0 0 0 0 0 
0 0 0 34 34 34 0 0 0 0 0 0 
0 0 0 0 0 18 18 18 18 0 0 0 
0 0 0 0 0 0 0 4 18 0 0 0 
9 0 0 0 0 0 0 4 18 0 0 0 
3 0 0 0 0 18 18 18 18 0 0 0 
0 0 0 0 0 0 0 0 0 0 0 0 
0 0 0 0 0 0 0 0 0 34 0 0 
34 34 34 34 34 0 0 0 34 0 0 0 
0 0 0 0 0 0 0 0 34 0 0 0 
41 0 0 0 0 0 0 34 34 0 4 0 

