12,12
4 0 6 0 0 0 0 0 13 0 4 4 
0 18 18 34 34 0 0 0 0 0 0 0 
0 18 34 34 0 0 0 0 18 18 18 0 
0 0 0 0 0 0 0 0 11 11 18 0 
0 0 0 0 0 0 0 0 11 11 0 0 
41 3 0 0 34 0 0 0 0 0 0 0 
0 0 0 0 0 0 0 34 34 0 0 0 
0 0 0 0 0 0 0 0 34 0 0 0 
0 34 0 0 34 0 0 0 0 18 34 34 
0 34 0 0 34 0 0 0 0 4 0 6 
6 34 0 0 34 34 0 0 0 18 0 1 
4 34 0 0 6 4 34 0 0 34 0 0 

