12,12
0 0 0 0 0 0 0 0 0 0 0 0 
18 18 18 0 18 0 18 18 18 18 0 0 
0 0 0 0 18 4 18 0 0 18 0 0 
0 0 0 0 18 4 18 0 0 18 0 0 
0 0 0 0 18 4 18 0 0 18 0 0 
0 0 0 0 18 18 18 0 0 18 0 0 
0 0 0 0 0 0 0 0 0 18 0 0 
0 34 4 34 0 0 0 0 0 18 0 0 
0 34 34 34 0 0 0 0 0 18 0 0 
0 0 0 0 0 0 0 0 0 18 0 0 
4 18 18 18 18 18 18 18 18 18 4 3 
0 0 0 0 0 0 0 0 0 0 0 25 

